#########################B####
                             #
##      ##     ###   ###  ## #
### ###    ##        ####  ###
A    ###    ### ###    #### ##
######           #########   #